IIIIIIIIIIIIIIIIIIIIIIIIIIIIIIIIIII
IIIIIIIIIIIIIIIIIIIMIIIIIIIIIIIIIII
IIIIIIIIIIIIMIIIIMMMIIIIIIIIIIIIIII
IIIIIIIIIIIIMMMMMMMMIIIIIIIIIIIIIII
IIIIIIIIIIIMMMK    MIIIIIIIIIIIIIII
IIIIIIIIIIIIIM  S  MIIIIIIIIIIIIIII
IIIIIIIIIIIIIM    dMMIIIIIIIIIIIIII
IIIIIIIIIIIIIM   B MMIIIIIIIIIIIIII
IIIIIIIIIIIIIM V   MMIIIIIIIIIIIIII
IIIIIIIIIMMMMM     MDIIIIIIIIIIIIII
IIIIIIIIIMMMMMM MMMMMIIIIIMMMIIIIMI
IIIIIIIMMMMMMDM MMIIIIIIIMMMMMDMMMI
IIIIIIIMM       MIIIIIIIIMMMMMMMMMI
IIIIIIIMM     MMMIIIIIIIMMM  d  MMI
IIIIIIIMM     MMMIIIIIIIIDM K K MMI
IIIIIIIMM V   DMMIIIIIIIIMD     MMI
IIIIIIIMD     MDMMMMMMMMDMDDDMDMDMI
IIIIIIIMM MMM MMMMMMMMMMMMM MDMDDMI
IIIIIIIMM MMM         MM        MDI
IMDMMMMMM MDMMMM  B      MM  d  MMI
IIIMM   C  M   M    B  MMMMMMDMMMMI
IIIMM      D p M    J  MMIMMMMMMMMI
IIIMM  C   MC  M      MMMIIIIIMMMII
IIIMMd     MMMMMMB B  MMMMIIIIIIIII
IIIDMMMMMMMMMMMMMBMMMMMDDMMIIIIIIII
IIIIMMMMIIIMMMDMMMMMMMMDMMMMMMMIIII
IIIIIIMIIIIIIIIMMBMDMDMMMMMMMMDMIII
IIIIIIIIIIIIIIIMM     MMM K    MMII
IIIIIIIIIIIIIIIMD      V     K MMII
IIIIIIIIIIIIIIMMM d    MM B s  MMMI
IIIIIIIIIIIIIIMMM     MMD      MMMI
IIIIIIIIIIIIIIMMMMMMMMMMDMMMMMMMMMI
IIIIIIIIIIIIIIMMMMMMMMMMMMMMMMMMMMI
IIIIIIIIIIIIIIIIIIIIIIIIIIIIIIIIIII
IIIIIIIIIIIIIIIIIIIIIIIIIIIIIIIIIII